1111111111111
10010000000C1
10C0011111001
1PC01100E00C1
1111111111111
