1111111
111E001
1111101
1C000C1
1000001
1110111
111P111
1111111
