1111111
111E001
1111101
1C100C1
1110001
1110111
111P111
1111111
