111111
1001E1
10C001
1PC011
111111
