1111111111111111111111111
1P00000000000000000000001
1110111000111110000111111
1C00001000000100001000001
1000111110001111100011111
100010000C000001000C00001
1111101111111111111101111
1C00001000000100001000001
1000001111111111111100001
1111111000000000000110111
1C000010001111110000C0001
1111100C00100000100011111
1E000010000000000010000C1
1111111111111111111111111
