1111111111111111111111111111111
1P00000000000000000000000000001
1110111000111110000111111111111
1C00001000000100001000000000001
1000111110001111100011111011111
100010000C000001000C00001000001
1111101111111111111101111111111
1C00001000000100001000001000001
1000001111111111111100000000001
1111111000000000000110111111011
1C000010001111110000C0000000001
1000100C00100000100011111011111
1000000100000000000100000000001
1111111111111111111111111011111
1000000000000000000000000000001
1111111111111101111111111111111
1000000000000000000000000000001
1111011111011111111111111111111
1C00000001000000000000000000001
1000111111111011111111101011111
1000000000100000000000000100001
1111111111111111111111110111111
1C100000000000000000C0000000001
1000011111111111011111111011111
10001000000000001000000000000E1
1111111111111111111111111111111
