111111111111111111111111111111111111111111111111111111111
1P0000000000000000000000000000000000000000000000000000001
111111111111100111111111111111111111111111111111111111111
1000000000000000000000000000000000000000000000000000000C1
1000000000000000000001111111111111000000000000000000000C1
1000000000000000000001111111111111000000000000000000000C1
111111111111111111100000000000000000000000000111111111111
1C00000000000000000000000000000000000000000000000000000E1
111111111111111111111111111111111000000000000111111111111
1C0000000000000000000000000000000000000000000000000000001
11111111111111111111111111111111111111C111111111111111111
1C0000000000000000000000000000000000000000000000000000001
1C0000000000000000000000000000000000000000000000000000001
11111111111111C111111111111111111111111111111111111111111
100000000000000000000000000000000000000000000000000000001
100000000000000000000000000000000000000000000000000000001
111111111111111111111111011111111111111111111111111111111
1C0000000000000000000000000000000000000000000000000000001
1C0000000000000000000000000000000000000000000000000000001
111111111111111111111111111111011111111111111111111111101
1C0000000000000000000000000000000000000000000000000000001
100000000000000000000000000000000000000000000000000000001
111111111111111111111111111111111111111111111111111111111
